codon	1-letter-symbol
TTT	F
TCT	S
TAT	Y
TGT	C
TTC	F
TCC	S
TAC	Y
TGC	C
TTA	L
TCA	S
TAA	*
TGA	W
TTG	L
TCG	S
TAG	*
TGG	W
CTT	T
CCT	P
CAT	H
CGT	R
CTC	T
CCC	P
CAC	H
CGC	R
CTA	T
CCA	P
CAA	Q
CGA	R
CTG	T
CCG	P
CAG	Q
CGG	R
ATT	I
ACT	T
AAT	N
AGT	S
ATC	I
ACC	T
AAC	N
AGC	S
ATA	M
ACA	T
AAA	K
AGA	R
ATG	M
ACG	T
AAG	K
AGG	R
GTT	V
GCT	A
GAT	D
GGT	G
GTC	V
GCC	A
GAC	D
GGC	G
GTA	V
GCA	A
GAA	E
GGA	G
GTG	V
GCG	A
GAG	E
GGG	G
